1,0,0,1,-1,0
2,1,0,1,-1,0
3,2,0,1,-1,0
4,3,0,1,-1,0
5,4,0,1,-1,0
6,5,0,0,-1,0
7,6,1,0,-1,0
8,7,1,0,-1,0
9,8,1,0,-1,0
10,9,1,0,-1,0
11,10,1,0,-1,0
12,9,1,0,-1,0
