1,0,0,0,-1,0
2,1,1,0,-1,0
3,2,1,0,-1,0
4,3,1,0,-1,0
5,8,1,0,-1,0
6,4,1,0,-1,0
7,5,1,0,-1,0
8,6,1,0,-1,0
9,7,1,0,-1,0
10,9,1,0,-1,0
